22222222222222222222
22222222222222222222
01122222222222222222
22112222222222222222
22212222222222222222
22212222222222222222
22212222222222222222
22112222222222222222
22122222222222222222
22111112222222222222
22222211122222222222
22222222111222222222
22222222221222222222
22222222221222222222
22222222211222222222
22222222212222222222
22222222211222222222
22222222221222222222
22222222221222222222
22222222223222222222
